10
30
oo****************************
******************************
*****ooo*******o********o*****
***************o*********oo***
**************ooo*************
******************************
*****ooo**********************
******************ooo**o******
**********************oo****oo
****************************o*
